0,0,0,0,0,0,0,0,0,0,0,0,0,0,0,0,0,0,0,0,0,0,0,0,0
0,-1,-1,-1,-1,-1,-1,-1,-1,-1,-1,-1,0,-1,-1,-1,-1,-1,-1,-1,-1,-1,-1,-1,0
0,-1,-1,-1,-1,-1,-1,-1,-1,-1,-1,-1,0,-1,-1,-1,-1,-1,-1,-1,-1,-1,-1,-1,0
0,-1,2,2,2,-1,3,3,3,3,-1,-1,0,-1,-1,3,3,3,3,-1,2,2,2,-1,0
0,-1,2,11,2,-1,3,11,11,3,-1,-1,0,-1,-1,3,11,11,3,-1,2,11,2,-1,0
0,-1,2,11,2,-1,3,11,11,3,-1,-1,0,-1,-1,3,11,11,3,-1,2,11,2,-1,0
0,-1,2,2,2,-1,3,3,3,3,-1,-1,0,-1,-1,3,3,3,3,-1,2,2,2,-1,0
0,-1,-1,-1,-1,-1,-1,-1,-1,-1,-1,-1,-1,-1,-1,-1,-1,-1,-1,-1,-1,-1,-1,-1,0
0,-1,-1,-1,-1,-1,-1,-1,-1,-1,-1,-1,-1,-1,-1,-1,-1,-1,-1,-1,-1,-1,-1,-1,0
0,-1,4,4,4,4,4,4,-1,5,5,5,5,5,5,5,-1,4,4,4,4,4,4,-1,0
0,-1,-1,-1,-1,-1,-1,4,-1,-1,-1,-1,5,-1,-1,-1,-1,4,-1,-1,-1,-1,-1,-1,0
0,-1,-1,-1,-1,-1,-1,-1,-1,-1,-1,-1,-1,-1,-1,-1,-1,-1,-1,-1,-1,-1,-1,-1,0
0,0,0,0,0,0,-1,-1,6,6,6,-1,-1,-1,6,6,6,-1,-1,0,0,0,0,0,0
11,11,11,11,11,0,-1,-1,6,-1,-1,-1,-1,-1,-1,-1,6,-1,-1,0,11,11,11,11,11
11,11,11,11,11,0,-1,-1,6,-1,-1,-1,-1,-1,-1,-1,6,-1,-1,0,11,11,11,11,11
11,11,11,11,11,0,-1,-1,6,-1,-1,-1,-1,-1,-1,-1,6,-1,-1,0,11,11,11,11,11
1,1,1,1,1,0,-1,-1,6,6,6,6,6,6,6,6,6,-1,-1,0,1,1,1,1,1
1,-1,-1,-1,-1,-1,-1,-1,-1,-1,-1,-1,-1,-1,-1,-1,-1,-1,-1,-1,-1,-1,-1,-1,1
1,-1,-1,-1,-1,-1,-1,-1,-1,-1,-1,-1,-1,-1,-1,-1,-1,-1,-1,-1,-1,-1,-1,-1,1
1,-1,7,7,7,7,-1,-1,8,8,8,8,8,8,8,8,8,-1,-1,7,7,7,7,-1,1
1,-1,7,11,11,7,-1,-1,-1,-1,-1,-1,-1,-1,-1,-1,-1,-1,-1,7,11,11,7,-1,1
1,-1,7,11,11,7,-1,-1,-1,-1,-1,-1,-1,-1,-1,-1,-1,-1,-1,7,11,11,7,-1,1
1,-1,7,11,11,7,7,7,7,-1,-1,-1,-1,-1,-1,-1,7,7,7,7,11,11,7,-1,1
1,-1,7,7,7,7,-1,-1,-1,-1,-1,-1,-1,-1,-1,-1,-1,-1,-1,7,7,7,7,-1,1
1,-1,-1,-1,-1,-1,-1,-1,-1,-1,-1,-1,-1,-1,-1,-1,-1,-1,-1,-1,-1,-1,-1,-1,1
1,-1,-1,-1,-1,-1,-1,-1,10,10,10,10,10,10,10,10,10,-1,-1,-1,-1,-1,-1,-1,1
1,-1,-1,-1,9,-1,-1,-1,-1,10,-1,-1,-1,-1,-1,10,-1,-1,-1,-1,9,-1,-1,-1,1
1,-1,-1,-1,9,-1,-1,-1,-1,10,-1,-1,-1,-1,-1,10,-1,-1,-1,-1,9,-1,-1,-1,1
1,-1,9,9,9,9,9,-1,-1,10,-1,-1,-1,-1,-1,10,-1,-1,9,9,9,9,9,-1,1
1,-1,-1,-1,9,-1,-1,-1,-1,10,-1,-1,-1,-1,-1,10,-1,-1,-1,-1,9,-1,-1,-1,1
1,-1,-1,-1,9,-1,-1,-1,-1,-1,-1,-1,-1,-1,-1,-1,-1,-1,-1,-1,9,-1,-1,-1,1
1,-1,-1,-1,-1,-1,-1,-1,-1,-1,-1,-1,-1,-1,-1,-1,-1,-1,-1,-1,-1,-1,-1,-1,1
1,1,1,1,1,1,1,1,1,1,1,1,1,1,1,1,1,1,1,1,1,1,1,1,1
